.H##......
#.##..###.
#.###.###.
#.....###.
###T#####G